#####
#o#x#
#   #
# ^ #
#####
